1111111111111111111
1000100000100000001
1010111110101111101
1010000000100010001
1011111111101110101
1010001000101000101
1010101010101011101
1200120010001000101
1111111111111110101
1000001200000012101
1011101110111010101
1000101000100010101
1110101011101110111
1002101000101000001
1011101110101111101
1200100010100002101
1110111010111110101
1002001000100000001
1111111111111111111
