1111111111111
1000000000101
1111101110101
1010001010001
1010111011101
1000100000101
1111111110101
1000000000101
1011111110101
1210000000101
1011111111101
1000020000021
1111111111111
