1111111111111
1010000010001
1010101010111
1010101210001
1010101011101
1000101000101
1111101110101
1202001000101
1111111011101
1002101000001
1010101111101
1010000000001
1111111111111
