1111111111111111111
1012101000000010001
1010101010111011101
1010100010100010021
1010101110101110111
1010101000120010001
1010111011111011101
1010000010001000001
1011111111101111101
1002000002001202001
1011111011111011111
1010001000020010001
1010101111111110111
1000100200100010021
1111111110101011101
1010000002121000101
1010111111101110101
1000000000021000021
1111111111111111111
