1111111111111
1000000202101
1011101110101
1010001010001
1110111010111
1000100010121
1011101010101
1010101000101
1110101111101
1010001200101
1010111010101
1000000010001
1111111111111
