1111111111111111111
1010000000001200001
1010111111101011101
1010001000101210001
1011101010101010111
1000100010100010001
1011111111111111101
1000021010001000001
1110101010101011111
1000101000121000101
1011111011101110101
1000100010000010101
1110101110111010101
1000100010120010101
1011101110101110101
1000001000100010001
1011111011111111101
1000001000000200001
1111111111111111111
